
KOL = "countries/Köln.txt"
TRE = "countries/Trier.txt"
MUR = "countries/Murmark.txt"
FCT = "countries/Franche-Comté.txt"
PLZ = "countries/Palsgraviate.txt"
LUN = "countries/Lüneburg.txt"
NCE = "countries/Nice.txt"
GAE = "countries/Gaeta.txt"
APL = "countries/Apulia.txt"
CLB = "countries/Calabria.txt"
SLR = "countries/Salerno.txt"
BNV = "countries/Benevento.txt"
ABZ = "countries/Abruzzo.txt"
JCH = "countries/Jülich.txt"
KLE = "countries/Cleves.txt"
MAI = "countries/Mainz.txt"
BBB = "countries/Bamberg.txt"
ANS = "countries/Ansbach.txt"
PSU = "countries/Passau.txt"
NBG = "countries/Neuberg.txt"
BCT = "countries/Berchtsgoan.txt"
VDE = "countries/Verden.txt"
SDE = "countries/Stade.txt"
XMN = "countries/Minden.txt"
TCK = "countries/Tecklenburg.txt"
XBT = "countries/Bentheim.txt"
ONB = "countries/Osnabrück.txt"
MUT = "countries/Münster.txt"
XMK = "countries/Mark.txt"
ABG = "countries/Arnsberg.txt"
DBT = "countries/Derbent.txt"
SRV = "countries/Shirvan.txt"
SYU = "countries/Syunik.txt"
CPU = "countries/Capua.txt"
GLL = "countries/Gallura.txt"
LGU = "countries/Logudoro.txt"
AOE = "countries/Arborea.txt"
CAG = "countries/Cagliari.txt"
BGM = "countries/Bergamo.txt"
BCI = "countries/Brescia.txt"
CMA = "countries/Cremona.txt"
PVA = "countries/Pavia.txt"
XNV = "countries/Novara.txt"
AVI = "countries/Avignon.txt"
IVR = "countries/Ivrea.txt"
PCA = "countries/Piacenza.txt"
AAB = "countries/Arba.txt"
SVO = "countries/Savona.txt"
NLI = "countries/Noli.txt"
XLN = "countries/Loano.txt"
ABN = "countries/Albenga.txt"
DAU = "countries/Dauphine.txt"