TKK = "countries/Tekke.txt"
ALY = "countries/Awlad Sidi Shaykh.txt"
AMH = "countries/Ain Madhi.txt"
MZA = "countries/Mzab.txt"
OUL = "countries/Ouargla.txt"
TGG = "countries/Touggourt.txt"
AZZ = "countries/Anazzah.txt"
MCS = "countries/Mascara.txt"
CNT = "countries/Constantine.txt"
ALH = "countries/Al Hasa.txt"
MSN = "countries/Massina.txt"
BD2 = "countries/Bida.txt"
BCH = "countries/Bauchi.txt"
ARO = "countries/Aro.txt"
STU = "countries/Samori Ture.txt"
TRZ = "countries/Trarza.txt"
ARR = "countries/Adrar.txt"
TGT = "countries/Tagant.txt"
KNN = "countries/Konni.txt"
GBR = "countries/Gobir.txt"
TSS = "countries/Tessaoua.txt"
DGR = "countries/Damagaram.txt"
EGB = "countries/Egba.txt"
AMW = "countries/Adamawa.txt"
RAZ = "countries/Rabih az Zubayr.txt"
DAK = "countries/Dar al Kuti.txt"
DMS = "countries/Dar Masalit.txt"
TBT = "countries/Tibesti.txt"
SNS = "countries/Senussi.txt"
BDR = "countries/Benadir.txt"
ABJ = "countries/Abuja.txt"
KDG = "countries/Kennedougou.txt"
IDN = "countries/Idoani.txt"
BGR = "countries/Bagirmi.txt"
NRI = "countries/Nri.txt"
BRK = "countries/Brakna.txt"
MND = "countries/Mandara.txt"
MDI = "countries/Mahdist Sudan.txt"
ZZZ = "countries/Zazzau.txt"
NJD = "countries/Nejd.txt"
PKU = "countries/Parakou.txt"
DJG = "countries/Djougou.txt"
NKK = "countries/Nikki.txt"
KWA = "countries/Kwande.txt"
WVB = "countries/Walvis Bay.txt"
BVY = "countries/Bovay.txt"
ILO = "countries/Illo.txt"
KDI = "countries/Kandi.txt"
DBO = "countries/Dagbon.txt"
ILR = "countries/Ilorin.txt"
KIM = "countries/Kaiama.txt"
SNR = "countries/Sandiro.txt"
BSS = "countries/Bussa.txt"
PSA = "countries/Poissa.txt"
BNN = "countries/Benin2.txt"
DMB = "countries/Dembo.txt"
KSJ = "countries/Kasanje.txt"
LND = "countries/Lunda.txt"
WMB = "countries/Wambu.txt"
BLU = "countries/Bailundo.txt"
CKW = "countries/Chokwe.txt"
KZM = "countries/Kazembe.txt"
BUE = "countries/Barue.txt"
GWK = "countries/Gwiriko.txt"
TTI = "countries/Tati Land.txt"
MSH = "countries/Mashonaland.txt"
MCL = "countries/Manicaland.txt"
NWD = "countries/Northwest Rhodesia.txt"
NED = "countries/Northeast Rhodesia.txt"
JPA = "countries/Japanese Antarctica.txt"
UBI = "countries/Ubangi.txt"
KV2 = "countries/Kivu.txt"
ULE = "countries/Uele.txt"
BKO = "countries/Boroko.txt"
ITI = "countries/Ituri.txt"
TCP = "countries/Transcaspia.txt"
ALS = "countries/Alash Orda.txt"
SEM = "countries/Samarkand.txt"
MEV = "countries/Merv.txt"
KGD = "countries/Karaganda.txt"
AKM = "countries/Akmola.txt"
ZHA = "countries/Zhambyl.txt"
SMY = "countries/Semey.txt"
SYM = "countries/Shymkent.txt"
AMT = "countries/Alma-Ata.txt"
KHW = "countries/Khorezm.txt"
BAI = "countries/Tyuratam.txt"
SYD = "countries/Syr Darya.txt"
AMD = "countries/Amu Darya.txt"
ZHE = "countries/Zhetisu.txt"
KUJ = "countries/Kuldja.txt"
KIZ = "countries/Kizilsu.txt"
FRG = "countries/Fergana.txt"
TKE = "countries/Tekke.txt"
ERS = "countries/Ersari.txt"
CHD = "countries/Chowdur.txt"
SRY = "countries/Saryk.txt"
YMT = "countries/Yomut.txt"
NUB = "countries/1.txt"
NUR = "countries/one.txt"
GLD = "countries/Golden Horde.txt"
JRS = "countries/Jerusalem.txt"
SKR = "countries/Serbian Krajina.txt"
UR2 = "countries/Ural League.txt"
SK2 = "countries/Sark.txt"
AL2 = "countries/Alderney.txt"
BKY = "countries/The Bukey Horde.txt"
CSK = "countries/Cossackia.txt"
KD0 = "countries/Rub al Khali Desert.txt"
SD0 = "countries/Sahara Desert.txt"
TD0 = "countries/Taklamakan Desert.txt"
TE2 = "countries/Tamil Eelam.txt"
SZ2 = "countries/Suez Canal.txt"
CIE = "countries/Cieszyn.txt"
TAI = "countries/Tai.txt"
BAC = "countries/Northern Vietnam.txt"
TNG = "countries/Tay Nguyen.txt"
LUA = "countries/Luang Phrabang.txt"
CPK = "countries/Champasak.txt"
VTN = "countries/Vientiane.txt"
WT2 = "countries/West Timor.txt"
BS2 = "countries/Bima.txt"
TD2 = "countries/Tidor.txt"
TN2 = "countries/Ternate.txt"
NMN = "countries/Naiman.txt"
KRE = "countries/Kirei.txt"
LGK = "countries/Langkat.txt"
DLI = "countries/Deli.txt"
SDG = "countries/Serdand.txt"
ASN = "countries/Asahan.txt"
SAK = "countries/Siak.txt"
IDG = "countries/Indragiri.txt"
PKL = "countries/Pakualman.txt"
SRK = "countries/Surakarta.txt"
YGY = "countries/Yogyakarta.txt"
MGG = "countries/Mangku Negaran.txt"
SBS = "countries/Sambas.txt"
MPW = "countries/Mempawah.txt"
PTK = "countries/Pontianak.txt"
KUU = "countries/Kubu.txt"
MA2 = "countries/Matan.txt"
SMP = "countries/Simpiang.txt"
KWG = "countries/Kotawaringin.txt"
SKD = "countries/Sekadau.txt"
AGG = "countries/Sanggau.txt"
MLS = "countries/Meliasi.txt"
TYN = "countries/Tayan.txt"
STG = "countries/Sintang.txt"
SLM = "countries/Selimbolu.txt"
BGL = "countries/Batang Lupar.txt"
SBW = "countries/Seberuwang.txt"
SLT = "countries/Silat.txt"
BNU = "countries/Bunut.txt"
PJS = "countries/Pijasa.txt"
SHD = "countries/Suhaid.txt"
SBB = "countries/Sabamban.txt"
KSN = "countries/Kusan.txt"
PLL = "countries/Pulau Laut.txt"
BLC = "countries/Batulicin.txt"
CTG = "countries/Cantung.txt"
BAA = "countries/Bangkalaan.txt"
MUG = "countries/Manunggul.txt"
SPH = "countries/Sampanahan.txt"
CGL = "countries/Cengal.txt"
PSR = "countries/Paser.txt"
KTK = "countries/Kutai Kartanegara.txt"
BLG = "countries/Bulungan.txt"
GGT = "countries/Gunung Tabur.txt"
SBG = "countries/Sambaliung.txt"
DGG = "countries/Donggala.txt"
TWL = "countries/Tawaeli.txt"
PAU = "countries/Palu.txt"
SGI = "countries/Sigi.txt"
KLW = "countries/Kulawi.txt"
TTL = "countries/Toli-Toli.txt"
BUO = "countries/Buol.txt"
BLM = "countries/Boalemo.txt"
GRT = "countries/Gorontalo.txt"
LMB = "countries/Limboto.txt"
ATG = "countries/Atinggola.txt"
SWW = "countries/Suwawa.txt"
KDP = "countries/Kaidipang.txt"
ITG = "countries/Itaga.txt"
BTU = "countries/Bintauna.txt"
BLA = "countries/Bolaang.txt"
BGO = "countries/Bulango.txt"
CHG = "countries/Changtang.txt"
HOR = "countries/Hor Gyade.txt"
MNO = "countries/Manado.txt"
TRJ = "countries/Toraja.txt"
SSN = "countries/Massen.txt"
LTA = "countries/Alitta.txt"
SPP = "countries/Suppa.txt"
SEG = "countries/Sidenreng.txt"
RRU = "countries/Barru.txt"
TNE = "countries/Tanete.txt"
SPE = "countries/Sopeng.txt"
WJO = "countries/Wajo.txt"
LUW = "countries/Luwu.txt"
TJO = "countries/Tojo.txt"
BGG = "countries/Banggai.txt"
BNK = "countries/Bungku.txt"
LWI = "countries/Laiwoi.txt"
EMP = "countries/Empanang.txt"
LDK = "countries/Landak.txt"
BLP = "countries/Balanipa.txt"
MMJ = "countries/Mamudju.txt"
BTG = "countries/Butung.txt"
AAA = "countries/Ala.txt"
MNR = "countries/Mandar.txt"
MAU = "countries/Mautong.txt"
PIG = "countries/Parigi.txt"
LET = "countries/Leta.txt"
KAA = "countries/Sudakana.txt"
KT2 = "countries/Kuangchouwan.txt"
KVO = "countries/Kirov.txt"
DDO = "countries/Dodecanese.txt"
DLN = "countries/Dalian.txt"
NSX = "countries/North Shansi.txt"
SCA = "countries/South Chahar.txt"
PRT = "countries/Prato.txt"
AEZ = "countries/Arezzo.txt"
SNA = "countries/Siena.txt"
GRS = "countries/Grosseto.txt"
LVR = "countries/Livorno.txt"
FLR = "countries/Florence.txt"
PIS = "countries/Pisa.txt"
SLU = "countries/Saluzzo.txt"
MOF = "countries/Monferrat.txt"
ASI = "countries/Asti.txt"
BOG = "countries/Bologna.txt"
PIO = "countries/Piombino.txt"
SAV = "countries/Savoy.txt"
MLO = "countries/Milan.txt"
JEH = "countries/Jehol.txt"
IRO = "countries/Iroquois.txt"
AFA = "countries/Afar.txt"
GBL = "countries/Gambela.txt"
TIG = "countries/Tigray.txt"
AMA = "countries/Amhara.txt"
BGZ = "countries/Benishangul Gumuz.txt"
ORM = "countries/Oromia.txt"
ADD = "countries/Addis Ababa.txt"
SNN = "countries/Southern Nations Nationalities and Peoples.txt"
SDM = "countries/Sidama.txt"
DRE = "countries/Dire Dawa.txt"
HAR = "countries/Harari.txt"
SMI = "countries/Somali.txt"
HSP = "countries/Hispaniola.txt"
WIF = "countries/West Indies.txt"
DER = "countries/Derge.txt"
ZHF = "countries/Zhefang.txt"
MAG = "countries/Mangshi.txt"
MGJ = "countries/Mengjiaodong.txt"
MNH = "countries/Menghan.txt"
MNI = "countries/Menghai.txt"
MBN = "countries/Mengban.txt"
GNY = "countries/Ganya.txt"
LPO = "countries/Leipo.txt"
MOS = "countries/Moso.txt"
ZSO = "countries/Zuosuo.txt"
GNG = "countries/Gengma.txt"
HAZ = "countries/Hazarajat.txt"
KFS = "countries/Kafiristan.txt"
STK = "countries/South Turkestan.txt"
BDK = "countries/Badakhshan.txt"
HB2 = "countries/Hopeh.txt"
CH3 = "countries/Chahar.txt"
YNP = "countries/Yanpien.txt"
USV = "countries/Upper Svaneti.txt"
LSV = "countries/Lower Svaneti.txt"
MNG = "countries/Mingrelia.txt"
TAR = "countries/Tarki.txt"
KSB = "countries/Koisubuli.txt"
AVR = "countries/Avar.txt"
DJB = "countries/Djaro-Belokani.txt"
BSR = "countries/Tabasaran.txt"
RTK = "countries/Karakaytak.txt"
GHB = "countries/Ghunib.txt"
TSD = "countries/Tsudakhar.txt"
MKH = "countries/Mekhtuli.txt"
KYI = "countries/Kyurin.txt"
GZH = "countries/Gazikumukh.txt"
ESU = "countries/Elisu.txt"
KLS = "countries/Kilis.txt"
MLP = "countries/Milan.txt"
KCP = "countries/Kochgiri.txt"
DJH = "countries/Dojhik.txt"
KLD = "countries/Khalidi.txt"
SNJ = "countries/Sinjar.txt"
BHT = "countries/Bohtan.txt"
BTL = "countries/Bitlis.txt"
BZD = "countries/Bayazid.txt"
HKK = "countries/Hakkari.txt"
SOR = "countries/Soran.txt"
BAB = "countries/Baban.txt"
ARL = "countries/Ardalan.txt"
JLL = "countries/Jalali.txt"
BHD = "countries/Bahdinan.txt"
SHK = "countries/Shakak.txt"
SDL = "countries/Shadlu.txt"
ZFR = "countries/Zafaranlu.txt"
MEH = "countries/Maragheh.txt"
CEE = "countries/Cree.txt"
IRC = "countries/Iron.txt"
BLF = "countries/Blackfoot.txt"
NZP = "countries/Nez Perce.txt"
UTE = "countries/Ute.txt"
CRW = "countries/Crow.txt"
SIO = "countries/Sioux.txt"
YAQ = "countries/Yaqui.txt"
SOC = "countries/Soconusco.txt"
INU = "countries/Innu.txt"
NUI = "countries/Inuit.txt"
TLI = "countries/Tlingit.txt"
KSK = "countries/Kaska.txt"
DNE = "countries/Dene.txt"
TUT = "countries/Tutchone.txt"
YUP = "countries/Yupik.txt"
GWI = "countries/Gwichin.txt"
ATH = "countries/Athabaska.txt"
SLN = "countries/Salina.txt"
MPC = "countries/Mapuche.txt"
THL = "countries/Tehuelche.txt"
ALF = "countries/Alacaluf.txt"
ONA = "countries/ONA.txt"
YAH = "countries/Yahgan.txt"
KIO = "countries/Kiowa.txt"
CMN = "countries/Comanche.txt"
APA = "countries/Apache.txt"
RUT = "countries/Rutul.txt"
AKH = "countries/Akhtypara.txt"
DOK = "countries/Dokuzpara.txt"
ATP = "countries/Altypara.txt"
OT2 = "countries/Northern Ontario.txt"
GYC = "countries/Guaycuru Tribes.txt"
BUA = "countries/Buenos Aires.txt"
PL2 = "countries/Generalgouvernement.txt"
UA2 = "countries/Reichskommissariat Ukraine.txt"
LV2 = "countries/Reichskommissariat Ostland.txt"
VRK = "countries/Vorkuta.txt"
ZKK = "countries/Zhekangzhou.txt"
LGQ = "countries/Langqu.txt"
LGB = "countries/Lengbian.txt"
CGB = "countries/Chenbian.txt"
BA2 = "countries/Badi.txt"
BWG = "countries/Bawang.txt"
DGN = "countries/Dangdong.txt"
WRI = "countries/Wori.txt"
BTH = "countries/Bathang.txt"
LTH = "countries/Lithang.txt"
RON = "countries/Rongwo.txt"
KBM = "countries/Kumbum.txt"
AXX = "countries/A.txt"
DSM = "countries/Dasima.txt"
WGS = "countries/Wang Shidai.txt"
LNN = "countries/Lanna.txt"
MUP = "countries/Ninh.txt"
SIP = "countries/Sipsong Panna.txt"
BIE = "countries/Houaphan.txt"
PHO = "countries/Phongsali.txt"
LNM = "countries/Luang Namtha.txt"
MPK = "countries/Muang Phou Kha.txt"
KCG = "countries/Kengcheng.txt"
CMI = "countries/Chiang Mai.txt"
MAE = "countries/Mae Hong Son.txt"
LAM = "countries/Lamphun.txt"
CRI = "countries/Chiang Rai.txt"
PHR = "countries/Phrae.txt"
NAN = "countries/Nan.txt"
LPG = "countries/Lampang.txt"
CMP = "countries/Champa.txt"
AH1 = "countries/Al Heera.txt"
AH2 = "countries/Al Hamriyah.txt"
DHO = "countries/Dhofar.txt"
RJV = "countries/Rojava.txt"
DGI = "countries/Dar Gimir.txt"
JSA = "countries/Anti Manchukuo and Japanese Salvation Army.txt"
COP = "countries/Communist Party of Korea.txt"
MRI = "countries/Mansuri.txt"
ABU = "countries/Abusi.txt"
AHM = "countries/Ahl Haydara Mansur.txt"
BBD = "countries/Bin Abadat.txt"
ADB = "countries/Al Dubi.txt"
HDM = "countries/Hadrami.txt"
MWS = "countries/Mawsata.txt"
BJG = "countries/Bijagos.txt"
TIK = "countries/Tikhvin.txt" 
LUK = "countries/Lutsk.txt"
RIV = "countries/Rivne.txt"
CRV = "countries/Chernivtsi.txt"
KME = "countries/Khmelnytskyi.txt"
ZHY = "countries/Zhytomyr.txt"
CKS = "countries/Cherkasy.txt"
KRO = "countries/Kirovohrad.txt"
MYK = "countries/Mykolaiv.txt"
KHE = "countries/Kherson.txt"
ZAP = "countries/Zaporizhia.txt"
PLV = "countries/Poltava.txt"
SUY = "countries/Sumy.txt"
DPR = "countries/Donetsk PR.txt"
LPR = "countries/Luhansk PR.txt"
BGE = "countries/Banggae.txt"
PBO = "countries/Pamboang.txt"
SDN = "countries/Sedana.txt"
TPL = "countries/Tappalang.txt"
ALE = "countries/Aralle.txt"
BBG = "countries/Bambang.txt"
MNN = "countries/Mantangnga.txt"
RNT = "countries/Rantebulahan.txt"
TBG = "countries/Tabang.txt"
TBL = "countries/Tabulahan.txt"
TQB = "countries/Tuqbi.txt"
TRQ = "countries/Taramanuq.txt"
ANZ = "countries/Annazah.txt"
ARP = "countries/Arpitania.txt"
BKK = "countries/Bakkara.txt"
BKB = "countries/Bangka-Belitung.txt"
BGK = "countries/Bengkulu.txt"
BS3 = "countries/Barus.txt"
JMB = "countries/Jambi.txt"
MTW = "countries/Mentawai.txt"
NSR = "countries/North Sumatra.txt"
SSR = "countries/South Sumatra.txt"
WSR = "countries/West Sumatra.txt"
BTN = "countries/Banten.txt"
WJV = "countries/West Java.txt"
CJV = "countries/Central Java.txt"
EJV = "countries/East Java.txt"
JKT = "countries/Jakarta.txt"
BJR = "countries/Banjar.txt"
KLK = "countries/Kalaka.txt"
PNH = "countries/Pinoh.txt"
SKU = "countries/Samtiaokiu.txt"
SRB = "countries/Saribas.txt"
SUU = "countries/Sulu.txt"
TKN = "countries/Taikong.txt"
TDG = "countries/Tidung.txt"
BLI = "countries/Bali.txt"
WNT = "countries/West Nusa Tenggara.txt"
ENT = "countries/East Nusa Tenggara.txt"
AGN = "countries/Agangnionjio.txt"
BNE = "countries/Bone.txt"
GOW = "countries/Gowa.txt"
NSI = "countries/North Sulawesi.txt"
SSI = "countries/South Sulawesi.txt"
WSI = "countries/West Sulawesi.txt"
ESI = "countries/Southeast Sulawesi.txt"
UNA = "countries/Una-Una.txt"
BCN = "countries/Bacan.txt"
NMA = "countries/North Maluku.txt"
AID = "countries/Aiduma.txt"
ATI = "countries/Aliati.txt"
FTG = "countries/Fatagar.txt"
RMB = "countries/Rumbati.txt"
IDP = "countries/Indrapura.txt"
ASG = "countries/Anak Sungai.txt"
SPT = "countries/Sungai Perut.txt"
PLB = "countries/Palembang.txt"
PAP = "countries/Papua.txt"
LMP = "countries/Lampung.txt"
PDR = "countries/Padri.txt"
BJM = "countries/Banjarmasin.txt"
MLU = "countries/Maluka.txt"
SKN = "countries/South Kalimantan.txt"
WKN = "countries/West Kalimantan.txt"
CSU = "countries/Central Sulawesi.txt"
PIA = "countries/Piasak.txt"
JKG = "countries/Jongkong.txt"
KW2 = "countries/Koiwai.txt"
SB1 = "countries/Sonid Right Banner.txt"
DB1 = "countries/Darhan Muminggan United Banner.txt"
UB1 = "countries/Urad Front Banner.txt"
UB2 = "countries/Urad West Banner.txt"
UB3 = "countries/Urad North Banner.txt"
KB1 = "countries/Khalkhyn West Banner.txt"
DB2 = "countries/Dorvon Khookhed Banner.txt"
KB2 = "countries/Khangin Banner.txt"
DB3 = "countries/Dalat Banner.txt"
OB1 = "countries/Otog Banner.txt"
UB4 = "countries/Uushin Banner.txt"
VB1 = "countries/Van Banner.txt"
ZB1 = "countries/Zuungar Banner.txt"
UB5 = "countries/Uushin Adgiin Banner.txt"
TB1 = "countries/Tumed Banner.txt"
KB3 = "countries/Khovoot Blue Banner.txt"
KB4 = "countries/Khovoot Red Banner.txt"
SB2 = "countries/Shuluun Red Banner.txt"
SB3 = "countries/Shuluun Yellow Banner.txt"
SB4 = "countries/Shuluun White Banner.txt"
TI1 = "countries/Torres Strait Islands.txt"
TI2 = "countries/Tiwi Islands.txt"
BES = "countries/Besut.txt"
OFR = "countries/Occupied France.txt"
BA3 = "countries/British Arctic Territories.txt"
GLG = "countries/Gilgit.txt"
ISL = "countries/Islamabad.txt"
AZK = "countries/Azad Kashmir.txt"
CDG = "countries/Chandigarh.txt"
KMR = "countries/Komi Republic.txt"
BL2 = "countries/Belgien-Nordfrankreich.txt"
BWP = "countries/British Western Pacific Territories.txt"
TAQ = "countries/Taqali.txt"
OSJ = "countries/Order of Saint John.txt"
AT1 = "countries/Pitjantjatjara.txt"
AT2 = "countries/Yolngu.txt"
AT3 = "countries/Ngandi.txt"
AT4 = "countries/Ngaatjatjarra.txt"
AT5 = "countries/Nakako.txt"
AT6 = "countries/Mitaka.txt"
AT7 = "countries/Wanggamala.txt"
AT8 = "countries/Yarluyandi.txt"
AT9 = "countries/Karangura.txt"
AT0 = "countries/Ngameni.txt"
AA1 = "countries/Mantjintjarra.txt"
AA2 = "countries/Ngaanyatjarra.txt"
AA3 = "countries/Martu.txt"
AA4 = "countries/Diyari.txt"
AA5 = "countries/Alyawarre.txt"
AA6 = "countries/Kaytetye.txt"
AA7 = "countries/Ngarlawongga.txt"
AA8 = "countries/Nyamal.txt"
AA9 = "countries/Bailgu.txt"
AA0 = "countries/Ngardi.txt"
AB1 = "countries/Warlpiri.txt"
AB2 = "countries/Pintupi.txt"
AB3 = "countries/Tjalkadjara.txt"
AB4 = "countries/Nangatadjara.txt"
AB5 = "countries/Wangkatha.txt"
AB6 = "countries/Nangatara.txt"
IA1 = "countries/Army of Eritrea.txt"
IA2 = "countries/Army of Somalia.txt"
ISK = "countries/Kulangsu.txt"
UPS = "countries/Upper Silesia.txt"
SM2 = "countries/Samoa Company.txt"
ADG = "countries/Kel Adagh.txt"
AJJ = "countries/Kel Ajjer.txt"
AYR = "countries/Kel Ayr.txt"
GS2 = "countries/Kel Gres.txt"
NJN = "countries/Najran.txt"
HLJ = "countries/Heilongjiang.txt"
JLN = "countries/Jilin.txt"
GMM = "countries/Gomma.txt"
GM2 = "countries/Gumma.txt"
JIM = "countries/Jimma.txt"
GRA = "countries/Gera.txt"
LME = "countries/Limmu-Ennarea.txt"
RMM = "countries/Bangsamoro.txt"
LNO = "countries/Lanao.txt"
MG1 = "countries/Sultanate of Maguindanao.txt"
MG2 = "countries/Maguindanao Tribes.txt"
PT1 = "countries/Tagalog Tribes.txt"
PT2 = "countries/Capiznon Tribes.txt"
PT3 = "countries/Akeanon Tribes.txt"
PT4 = "countries/Cuyonon Tribes.txt"
PT5 = "countries/Hiligaynon Tribes.txt"
PT6 = "countries/Kamayo Tribes.txt"
PT7 = "countries/Hamtikanon Tribes.txt"
PT8 = "countries/Zamboangueno Tribes.txt"
PT9 = "countries/Bisaya Tribes.txt"
PT0 = "countries/Cebuano Tribes.txt"
MBW = "countries/Mbwila.txt"
QT1 = "countries/Koknar.txt"
QT2 = "countries/Koko-Bera.txt"
QT3 = "countries/Yir-Yiront.txt"
QT4 = "countries/Thaayorre.txt"
IN1 = "countries/Inupiat.txt"
IN2 = "countries/Inuvialuit.txt"
IN3 = "countries/Inughuit.txt"
AUI = "countries/Aleutian Islands.txt"
WKY = "countries/Wakaya.txt"
AMJ = "countries/Anmatjere.txt"
BJI = "countries/Banjima.txt"
A00 = "countries/Ngalea.txt"
A01 = "countries/Warumungu.txt"
A02 = "countries/Wakabunga.txt"
A03 = "countries/Bulamu.txt"
A04 = "countries/Luritja.txt"
A05 = "countries/Yankuntjatjara.txt"
A06 = "countries/Kokatha.txt"
A07 = "countries/Wirangu.txt"
A08 = "countries/Mirning.txt"
A09 = "countries/Ngarinyin.txt"
A10 = "countries/Arrernte.txt"
A11 = "countries/Wangkangurru.txt"
A12 = "countries/Antakarinja.txt"
A13 = "countries/Nana.txt"
A14 = "countries/Wawula.txt"
A15 = "countries/Kalaako.txt"
A16 = "countries/Ngatjumay.txt"
A17 = "countries/Tjupany.txt"
A18 = "countries/Arabana.txt"
A19 = "countries/Dhirari.txt"
A20 = "countries/Andegerebinha.txt"
A21 = "countries/Kuyani.txt"
A22 = "countries/Andyamathanha.txt"
A23 = "countries/Billiluna.txt"
A24 = "countries/Nyangumarda.txt"
A25 = "countries/Jaru.txt"
A26 = "countries/Warluwarra.txt"
A27 = "countries/Yanda.txt"
A28 = "countries/Gooniyandi.txt"
A29 = "countries/Nyikina.txt"
A30 = "countries/Walmatjarri.txt"
A31 = "countries/Mangala.txt"
A32 = "countries/Worora.txt"
A33 = "countries/Wunambul.txt"
A34 = "countries/Gamberre.txt"
A35 = "countries/Miwa.txt"
A36 = "countries/Kwini.txt"
A37 = "countries/Yiiji.txt"
A38 = "countries/Kadjerong.txt"
A39 = "countries/Doolboong.txt"
A40 = "countries/Kalkadoon.txt"
A41 = "countries/Yalarrnga.txt"
A42 = "countries/Pitapita.txt"
A43 = "countries/Badtjala.txt"
A44 = "countries/Warnindilyakwa.txt"
A45 = "countries/Nunggubuyu.txt"
A46 = "countries/Wudjari.txt"
A47 = "countries/Amarak.txt"
A48 = "countries/Nakara.txt"
A49 = "countries/Burarra.txt"
A50 = "countries/Gunbalang.txt"
A51 = "countries/Gungurugoni.txt"
A52 = "countries/Ngombur.txt"
A53 = "countries/Mbukarla.txt"
A54 = "countries/Wuningangk.txt"
A55 = "countries/Gagudju.txt"
A56 = "countries/Rembarnga.txt"
A57 = "countries/Ngalkbun.txt"
A58 = "countries/Gunwinggu.txt"
A59 = "countries/Dangbon.txt"
A60 = "countries/Iwaidja.txt"
A61 = "countries/Maung.txt"
A62 = "countries/Gunibidji.txt"
A63 = "countries/Bininj.txt"
A64 = "countries/Bukurnidja.txt"
A65 = "countries/Mara.txt"
JHN = "countries/Jhansi.txt"
SGM = "countries/Speer's Germany.txt"
HGM = "countries/Heydrich's Germany.txt"
BGM = "countries/Bormann's Germany.txt"
GGM = "countries/Goering's Germany.txt"
DN2 = "countries/Reichskommissariat Danmark.txt"
HL2 = "countries/Reichskommissariat Niederlande.txt"
NR2 = "countries/Reichskommissariat Norwegen.txt"
MC2 = "countries/Reichskommissariat Moskowien.txt"
KC2 = "countries/Reichskommissariat Kaukasus.txt"
BRN = "countries/Barnaul.txt"
MWC = "countries/Moscow City.txt"
SP3 = "countries/Saint Petersburg City.txt"
SSC = "countries/Sevastopol City.txt"
KRG = "countries/Kurgan.txt"
NVG = "countries/Novgorod.txt"
KLR = "countries/Kaliningrad.txt"
BGD = "countries/Belgorod.txt"
TAM = "countries/Tambov.txt"
LPT = "countries/Lipetsk.txt"
BYS = "countries/Bryansk.txt"
RYA = "countries/Ryazan.txt"
TUL = "countries/Tula.txt"
KGA = "countries/Kaluga.txt"
TVE = "countries/Tver.txt"
VDM = "countries/Vladimir.txt"
YAR = "countries/Yaroslavl.txt"
KLO = "countries/Kel Owey.txt"
KLT = "countries/Kel Ataram.txt"
KLN = "countries/Kel Dinnik.txt"
BLK = "countries/The Balkans.txt"
MAI = "countries/French Maine.txt"
ACO = "countries/Alencon.txt"
CPG = "countries/Champangne.txt"
NVR = "countries/Nevers.txt"
LMO = "countries/Limousin.txt"
AUV = "countries/Auvergne.txt"
DAU = "countries/Dauphine.txt"
BEY = "countries/Berry.txt"
BOU = "countries/Bourbon.txt"
TOU = "countries/Touraine.txt"
FRC = "countries/Franche-Comte.txt"
POI = "countries/Poitou.txt"
LYO = "countries/Lyon.txt"
FOI = "countries/Foix.txt"
MCE = "countries/La Marche.txt"
GYN = "countries/Guyenne.txt"
HLL = "countries/Holland Province.txt"
RTH = "countries/Rethel.txt"
BH2 = "countries/Bushahr.txt"
HS1 = "countries/Kotgarh.txt"
HS2 = "countries/Delath.txt"
HS3 = "countries/Kanethi.txt"
HS4 = "countries/Mangal.txt"
HS5 = "countries/Kotkhai.txt"
HS6 = "countries/Nalagarh.txt"
HS7 = "countries/Mahlog.txt"
HS8 = "countries/Kumharsain.txt"
HS9 = "countries/Sangri.txt"
HS0 = "countries/Baghal.txt"
H00 = "countries/Bhajji.txt"
H01 = "countries/Dhami.txt"
H02 = "countries/Kuthar.txt"
H03 = "countries/Kalsia.txt"
H04 = "countries/Madhan.txt"
H05 = "countries/Koti.txt"
H06 = "countries/Theog.txt"
H07 = "countries/Balsan.txt"
H08 = "countries/Kunihar.txt"
H09 = "countries/Baraoli.txt"
H10 = "countries/Baghat.txt"
H11 = "countries/Keonthal.txt"
H12 = "countries/Ghund.txt"
H13 = "countries/Rawin.txt"
H14 = "countries/Jubbal.txt"
H15 = "countries/Tharoch.txt"
H16 = "countries/Darkoti.txt"
H17 = "countries/Oudh.txt"
H18 = "countries/Tulsipur.txt"
H19 = "countries/Ahirwal.txt"
H20 = "countries/Satara.txt"
H21 = "countries/Nagpur.txt"
H22 = "countries/Garo.txt"
H23 = "countries/Kumaon.txt"
H24 = "countries/Jagdishpur.txt"
H25 = "countries/Dimasa.txt"
H26 = "countries/Calicut.txt"
H27 = "countries/Pnar.txt"
H28 = "countries/Kangra.txt"
H29 = "countries/Datarpur.txt"
H30 = "countries/Siba.txt"
H31 = "countries/Guler.txt"
H32 = "countries/Nurpur.txt"
H33 = "countries/Kullu.txt"
H34 = "countries/Spiti.txt"
H35 = "countries/Lahaul.txt"
H36 = "countries/Kannur.txt"
H37 = "countries/Kittur.txt"
H38 = "countries/Jaswan.txt"
H39 = "countries/Kutlehar.txt"
H40 = "countries/Nakodar.txt"
H41 = "countries/Surat.txt"
H42 = "countries/Sambalpur.txt"
H43 = "countries/Ballabhgarh.txt"
H44 = "countries/Jalaun.txt"
H45 = "countries/Jaitpur.txt"
H46 = "countries/Banda.txt"
H47 = "countries/Kurnool.txt"
H48 = "countries/Ramgarh.txt"
H49 = "countries/Angul.txt"
H50 = "countries/Nargund.txt"
H51 = "countries/Thanjavur.txt"
WAG = "countries/Wag.txt"
E00 = "countries/Dawro.txt"
E01 = "countries/Welayta.txt"
E02 = "countries/Wollo.txt"
E03 = "countries/Gubba.txt"
E04 = "countries/Dawe.txt"
E05 = "countries/Shewa.txt"
E06 = "countries/Gurage.txt"
E07 = "countries/Silt'e.txt"
E08 = "countries/Hadiya.txt"
E09 = "countries/Kambaata.txt"
E10 = "countries/Halaba.txt"
E11 = "countries/Janjero.txt"
E12 = "countries/Ethiopian Garo.txt"
E13 = "countries/Konso.txt"
E14 = "countries/Gamo.txt"
E15 = "countries/Aari.txt"
E16 = "countries/Gedeo.txt"
E17 = "countries/Leeqa-Nekemte.txt"
E18 = "countries/Ambo.txt"
E19 = "countries/Ethiopian Sant.txt"
E20 = "countries/Begemder.txt"
E21 = "countries/Gojjam.txt"
E22 = "countries/Lasta.txt"
E23 = "countries/Semien.txt"
E24 = "countries/Wolkait.txt"
ANO = "countries/Al-Nosur.txt"
HRM = "countries/Al-Haram.txt"
BTM = "countries/Banu Tamim.txt"
BMK = "countries/Banu Malik.txt"
HMA = "countries/Banu Hamad.txt"
BUB = "countries/Banu Ubeydel.txt"
BNA = "countries/Banu Ali.txt"
BBS = "countries/Banu Bishr.txt"
MRZ = "countries/Al-Marzuq.txt"
QAW = "countries/Qawasim.txt"
ABB = "countries/Abbasids.txt"
ABA = "countries/Abu Arish.txt"
AAS = "countries/Asir Al-Sarah.txt"
MHW = "countries/Mahwali.txt"
ATF = "countries/Atifi.txt"
AGH = "countries/Aghbari.txt"
KLL = "countries/Kaluli.txt"
BMI = "countries/Buraimi.txt"
RUJ = "countries/Rujai.txt"
HUA = "countries/Humaidi.txt"
MTR = "countries/Mataral.txt"
MAK = "countries/Makhdumi.txt"
RAD = "countries/Radfan.txt"
RUB = "countries/Rudbeaten.txt"
JBN = "countries/Juban.txt"
NAW = "countries/Nawa.txt"
BED = "countries/Beda.txt"
AZN = "countries/Azzan.txt"
WHJ = "countries/Wadi Hajr.txt"
ABY = "countries/Al-Burayki.txt"
HMU = "countries/Hamum.txt"
TM2 = "countries/Tamim.txt"
HNY = "countries/Hanyan.txt"
AAY = "countries/Al-Aydarus.txt"
BSU = "countries/Bin Sumayt.txt"
HBZ = "countries/Hawtat Ahmad bin Zayn.txt"
AJW = "countries/Al-Jawabir.txt"
HMT = "countries/Husn Mutahhar.txt"
GHR = "countries/Al-Gharama.txt"
JLE = "countries/Juledi.txt"
JUR = "countries/Jurabi.txt"
TKT = "countries/Tekrikrit.txt"
E25 = "countries/Shilluk.txt"
CPT = "countries/Cherepovets.txt"
GML = "countries/Gomel.txt"
PL3 = "countries/Polish Home Army.txt"
GZS = "countries/Gaza.txt"
AQ1 = "countries/Nusrat al-Islam.txt"
IS1 = "countries/Islamic State in the Greater Sahara.txt"
IS2 = "countries/Islamic State in Somalia.txt"
AQ2 = "countries/Al-Shabaab.txt"
YM1 = "countries/Supreme Political Council.txt"
YM2 = "countries/Southern Transitional Council.txt"
IS3 = "countries/Islamic State - West Africa Province.txt"
AQ3 = "countries/Boko Haram.txt"
AQ4 = "countries/Ansar al-Sharia.txt"
IS4 = "countries/Ansar al-Sunna.txt"
SR1 = "countries/Maghaweir al-Thowra.txt"
SR2 = "countries/Syrian National Army.txt"
SR3 = "countries/Syrian Salvation Government.txt"
AUK = "countries/Aukstaitija.txt"
DZU = "countries/Dzukija.txt"
SUV = "countries/Suvalkija.txt"
LMI = "countries/Lithuania Minor.txt"
RAF = "countries/Russian Army.txt"
NC2 = "countries/Nice.txt"
CU2 = "countries/Chuuk.txt"
CAG = "countries/Titteri.txt"
SBA = "countries/Beni Abbas.txt"
TT1 = "countries/Maasai.txt"
TT2 = "countries/Sagara.txt"
TT3 = "countries/Gogo.txt"
TT4 = "countries/Hehe.txt"
A66 = "countries/Kija.txt"
A67 = "countries/Gurindji.txt"
A68 = "countries/Ngarinman.txt"
A69 = "countries/Nungali.txt"
A70 = "countries/Ngaliwuru.txt"
A71 = "countries/Bilinara.txt"
A72 = "countries/Warlmanpa.txt"
A73 = "countries/Karajarri.txt"
A74 = "countries/Worla.txt"
A75 = "countries/Bunuba.txt"
A76 = "countries/Unggumi.txt"
A77 = "countries/Umida.txt"
A78 = "countries/Unggarangi.txt"
A79 = "countries/Warwa.txt"
A80 = "countries/Karangpurru.txt"
A81 = "countries/Mudburra.txt"
A82 = "countries/Jingili.txt"
A83 = "countries/Wiljali.txt"
A84 = "countries/Danggali.txt"
A85 = "countries/Barkindji.txt"
A86 = "countries/Meru.txt"
A87 = "countries/Wandjiwalgu.txt"
A88 = "countries/Bandjigali.txt"
A89 = "countries/Malyangaba.txt"
A90 = "countries/Karenggapa.txt"
A91 = "countries/Wadigali.txt"
A92 = "countries/Yawarawarka.txt"
A93 = "countries/Yandruwandha.txt"
A94 = "countries/Pirlatapa.txt"
A95 = "countries/Konbudj.txt"
A96 = "countries/Limilngan.txt"
A97 = "countries/Woolna.txt"
A98 = "countries/Warray.txt"
A99 = "countries/Jawoyn.txt"
TA0 = "countries/Ngangikurungkurr.txt"
TA1 = "countries/Marringarr.txt"
TA2 = "countries/Murinbata.txt"
TA3 = "countries/Jaminjung.txt"
TA4 = "countries/Wardaman.txt"
TA5 = "countries/Yangman.txt"
TA6 = "countries/Mangarayi.txt"
TA7 = "countries/Ngalakan.txt"
TA8 = "countries/Alawa.txt"
TA9 = "countries/Ngandji.txt"
AB7 = "countries/Wambaya.txt"
M00 = "countries/German Army"
M01 = "countries/Italian Army"
BLH = "countries/Balch.txt"
WAZ = "countries/Wahadi Azzan.txt"
RIG = "countries/Riga.txt"
WR2 = "countries/Reichskommissariat Weißruthenien.txt"
CZ2 = "countries/Bohmen.txt"
TKG = "countries/Tashkurgan.txt"
KDZ = "countries/Kunduz.txt"
KLB = "countries/Kulab.txt"
DVZ = "countries/Darwaz.txt"
HSR = "countries/Hissar.txt"
ROS = "countries/Roshan.txt"
SHN = "countries/Shighnan.txt"
ADK = "countries/Andhkui.txt"
SBN = "countries/Shibarghan.txt"
SIU = "countries/Sar-i-Pul.txt"
MMN = "countries/Maimana.txt"
AKC = "countries/Akchah.txt"
HRT = "countries/Herat.txt"
KDR = "countries/Kandahar.txt"
KBU = "countries/Kabul.txt"
SST = "countries/Sistan.txt"
DIN = "countries/Danish India.txt"
DVR = "countries/The Far East.txt"
ALI = "countries/Altai.txt"
GVK = "countries/German Volksreich.txt"
OM2 = "countries/Oromo Liberation Army.txt"
BMV = "countries/Manavadar.txt"
LRA = "countries/Lord's Resistance Army.txt"
CA0 = "countries/Messiria.txt"
CA1 = "countries/Chinko Nature Reserve.txt"
CA2 = "countries/Bamingui-Bangoran National Park.txt"
CA3 = "countries/Manovo-Gounda National Park.txt"
CA4 = "countries/Party of the Rally of the Central African Nation.txt"
CA5 = "countries/Popular Front for the Rebirth of Central African Republic.txt"
CA6 = "countries/Return Reclamation Rehabilitation.txt"
CA7 = "countries/Central African Patriotic Movement.txt"
CA8 = "countries/Union for Peace in the Central African Republic.txt"
CA9 = "countries/Anti-balaka.txt"
KTO = "countries/Kiautschou.txt"
EUR = "countries/Europe.txt"
C00 = "countries/Cooperative for Development of the Congo.txt"
C01 = "countries/Ituri Self-Defense Popular Front.txt"
C02 = "countries/Patriotic and Integrationist Front of Congo.txt"
C03 = "countries/Patriotic Resistance Front of Ituri.txt"
C04 = "countries/Mai-Mai Kyandenga.txt"
C05 = "countries/Mai-Mai Ninja.txt"
C06 = "countries/Union of Patriots for the Liberation of Congo.txt"
C07 = "countries/Allied Democratic Forces.txt"
C08 = "countries/People's Peace Forces.txt"
C09 = "countries/Raia Mutomboki.txt"
C10 = "countries/Rally for Unity and Democracy.txt"
C11 = "countries/Nyatura Militias.txt"
C12 = "countries/Alliance of Patriots for a Free and Sovereign Congo.txt"
C13 = "countries/Democratic Forces for the Liberation of Rwanda.txt"
C14 = "countries/March 23 Movement.txt"
C15 = "countries/Nduma Defense of Congo - Renovated.txt"
C16 = "countries/Mai-Mai Kifuafua.txt"
BSC = "countries/Baltic Sea.txt"
C17 = "countries/Resistance Movement for the Rule of Law - Tabara.txt"
C18 = "countries/Mai-Mai Mwenyemali.txt"
C19 = "countries/Mai-Mai Kidjangala.txt"
C20 = "countries/Mai-Mai Nyerere.txt"
C21 = "countries/People's National Coalition for the Sovereignty of the Congo.txt"
C22 = "countries/Mai-Mai Rene.txt"
C23 = "countries/Mai-Mai Reunion.txt"
C24 = "countries/Mai-Mai Ebu Ela.txt"
C25 = "countries/Mai-Mai Biloze Bishambuke.txt"
C26 = "countries/Twiganeho.txt"
C27 = "countries/Mai-Mai Alida.txt"
MB0 = "countries/Setsen Zasgiin Banner.txt"
MB1 = "countries/Altai Uriankhai Dyetyei Zasgiin Banner.txt"
MB2 = "countries/Erdene Yalgasan Monastery.txt"
MB3 = "countries/Khovsgol.txt"
MB4 = "countries/Dariganga.txt"
MB5 = "countries/Ulaanbaatar.txt"
M02 = "countries/MongolBanner2.txt"
M03 = "countries/MongolBanner3.txt"
M04 = "countries/MongolBanner4.txt"
M05 = "countries/MongolBanner5.txt"
M06 = "countries/MongolBanner6.txt"
M07 = "countries/MongolBanner7.txt"
M08 = "countries/MongolBanner8.txt"
M09 = "countries/MongolBanner9.txt"
M10 = "countries/MongolBanner10.txt"
M11 = "countries/MongolBanner11.txt"
M12 = "countries/MongolBanner12.txt"
M13 = "countries/MongolBanner13.txt"
M14 = "countries/MongolBanner14.txt"
M15 = "countries/MongolBanner15.txt"
M16 = "countries/MongolBanner16.txt"
M17 = "countries/MongolBanner17.txt"
M18 = "countries/MongolBanner18.txt"
M19 = "countries/MongolBanner19.txt"
M20 = "countries/MongolBanner20.txt"
M21 = "countries/MongolBanner21.txt"
M22 = "countries/MongolBanner22.txt"
M23 = "countries/MongolBanner23.txt"
M24 = "countries/MongolBanner24.txt"
M25 = "countries/MongolBanner25.txt"
M26 = "countries/MongolBanner26.txt"
M27 = "countries/MongolBanner27.txt"
M28 = "countries/MongolBanner28.txt"
M29 = "countries/MongolBanner29.txt"
M30 = "countries/MongolBanner30.txt"
M31 = "countries/MongolBanner31.txt"
M32 = "countries/MongolBanner32.txt"
M33 = "countries/MongolBanner33.txt"
M34 = "countries/MongolBanner34.txt"
M35 = "countries/MongolBanner35.txt"
M36 = "countries/MongolBanner36.txt"
M37 = "countries/MongolBanner37.txt"
M38 = "countries/MongolBanner38.txt"
M39 = "countries/MongolBanner39.txt"
M54 = "countries/MongolBanner54.txt"
M55 = "countries/MongolBanner55.txt"
M56 = "countries/MongolBanner56.txt"
M57 = "countries/MongolBanner57.txt"
M58 = "countries/MongolBanner58.txt"
M59 = "countries/MongolBanner59.txt"
M60 = "countries/MongolBanner60.txt"
M61 = "countries/MongolMonastery61.txt"
M62 = "countries/MongolBanner62.txt"
M63 = "countries/MongolBanner63.txt"
M64 = "countries/MongolBanner64.txt"
M65 = "countries/MongolBanner65.txt"
M66 = "countries/MongolBanner66.txt"
M67 = "countries/MongolBanner67.txt"
M68 = "countries/MongolBanner68.txt"
M69 = "countries/MongolBanner69.txt"
M70 = "countries/MongolBanner70.txt"
M71 = "countries/MongolMonastery71.txt"
M72 = "countries/MongolBanner72.txt"
M73 = "countries/MongolBanner73.txt"
M74 = "countries/MongolMonastery74.txt"
M75 = "countries/MongolBanner75.txt"
M76 = "countries/MongolBanner76.txt"
M77 = "countries/MongolBanner77.txt"
M78 = "countries/MongolBanner78.txt"
M79 = "countries/MongolMonastery79.txt"
M80 = "countries/MongolMonastery80.txt"
M81 = "countries/MongolBanner81.txt"
M82 = "countries/MongolBanner82.txt"
M83 = "countries/MongolBanner83.txt"
M84 = "countries/MongolBanner84.txt"
M85 = "countries/MongolBanner85.txt"
M86 = "countries/MongolBanner86.txt"
M87 = "countries/MongolBanner87.txt"
M88 = "countries/MongolMonastery88.txt"
M89 = "countries/MongolBanner89.txt"
M90 = "countries/MongolBanner90.txt"
M91 = "countries/MongolMonastery91.txt"
M92 = "countries/MongolBanner92.txt"
M93 = "countries/MongolMonastery93.txt"
M94 = "countries/MongolMonastery94.txt"
M95 = "countries/MongolMonastery95.txt"
M96 = "countries/MongolBanner96.txt"
M97 = "countries/MongolBanner97.txt"
M98 = "countries/MongolMonastery98.txt"
M99 = "countries/MongolBanner99.txt"
B00 = "countries/MongolBanner100.txt"
B01 = "countries/MongolBanner101.txt"
B02 = "countries/MongolBanner102.txt"
B03 = "countries/MongolMonastery103.txt"
B04 = "countries/MongolBanner104.txt"
B05 = "countries/MongolBanner105.txt"
B06 = "countries/MongolBanner106.txt"
B07 = "countries/MongolBanner107.txt"
B08 = "countries/MongolBanner108.txt"
B14 = "countries/MongolBanner114.txt"
B15 = "countries/MongolBanner115.txt"
B16 = "countries/MongolBanner116.txt"
B17 = "countries/MongolBanner117.txt"
B19 = "countries/MongolBanner119.txt"
B20 = "countries/MongolBanner120.txt"
B21 = "countries/MongolBanner121.txt"
B22 = "countries/MongolBanner122.txt"
B23 = "countries/MongolBanner123.txt"
B24 = "countries/MongolBanner124.txt"
B25 = "countries/MongolBanner125.txt"
B26 = "countries/MongolBanner126.txt"
B27 = "countries/MongolBanner127.txt"
B28 = "countries/MongolBanner128.txt"
B29 = "countries/MongolBanner129.txt"
B30 = "countries/MongolBanner130.txt"
B31 = "countries/MongolBanner131.txt"
B32 = "countries/MongolBanner132.txt"
B33 = "countries/MongolBanner133.txt"
B34 = "countries/MongolBanner134.txt"
B35 = "countries/MongolBanner135.txt"
B36 = "countries/MongolBanner136.txt"
B37 = "countries/West Imperial Camel Pasture.txt"
B38 = "countries/East Imperial Camel Pasture.txt"
B39 = "countries/West Imperial Horse Pasture.txt"
B40 = "countries/East Imperial Horse Pasture.txt"
B41 = "countries/Imperial Sheep Pasture.txt"
B42 = "countries/MongolBanner142.txt"
B43 = "countries/MongolBanner143.txt"
B44 = "countries/MongolBanner144.txt"
B45 = "countries/MongolBanner145.txt"
B46 = "countries/MongolBanner146.txt"
B47 = "countries/MongolBanner147.txt"
B48 = "countries/MongolBanner148.txt"
B49 = "countries/MongolBanner149.txt"
B50 = "countries/MongolBanner150.txt"
B51 = "countries/MongolBanner151.txt"
B52 = "countries/MongolBanner152.txt"
B53 = "countries/MongolBanner153.txt"
B54 = "countries/MongolBanner154.txt"
B55 = "countries/MongolBanner155.txt"
B56 = "countries/MongolBanner156.txt"
B57 = "countries/MongolBanner157.txt"
B58 = "countries/MongolBanner158.txt"
B59 = "countries/MongolBanner159.txt"
B60 = "countries/MongolBanner160.txt"
B61 = "countries/MongolBanner161.txt"
B62 = "countries/MongolBanner162.txt"
B63 = "countries/MongolBanner163.txt"
B64 = "countries/MongolBanner164.txt"
B65 = "countries/MongolBanner165.txt"
B66 = "countries/MongolBanner166.txt"
B67 = "countries/MongolMonastery167.txt"
MB6 = "countries/Mergen Noyon Monastery.txt"
MB7 = "countries/Zorig Beis Navaantserengiin Banner.txt"
MB8 = "countries/Northern Military Frontier.txt"
MB9 = "countries/Manlai Van Damdinsurengiin Banner.txt"
BM0 = "countries/Bishrelt Byeiliin Banner.txt"
BM1 = "countries/Khuuchidvan Selnendojilyn Banner.txt"
BM2 = "countries/Yalguunbaatar Beis Sumiyaagiin Banner.txt"
AFR = "countries/Africa.txt"
I16 = "countries/MongolBanner216.txt"
I17 = "countries/MongolBanner217.txt"
I18 = "countries/MongolBanner218.txt"
I19 = "countries/MongolBanner219.txt"
I20 = "countries/MongolBanner220.txt"
I21 = "countries/MongolBanner221.txt"
I22 = "countries/MongolBanner222.txt"
I23 = "countries/MongolBanner223.txt"
I24 = "countries/MongolBanner224.txt"
I25 = "countries/MongolBanner225.txt"
AVN = "countries/Franco-Britain.txt"
ERH = "countries/Earth.txt"
RPI = "countries/Rupununi.txt"
MAF = "countries/Mittelafrika.txt"
LPV = "countries/Leopoldville.txt"
GKR = "countries/Kaiserreich.txt"
WGG = "countries/Wagner Group.txt"
RSF = "countries/Rapid Support Forces.txt"
B69 = "countries/MongolBanner169.txt"
B70 = "countries/MongolBanner170.txt"
B71 = "countries/MongolBanner171.txt"
B72 = "countries/MongolBanner172.txt"
B73 = "countries/MongolBanner173.txt"
B74 = "countries/MongolBanner174.txt"
B75 = "countries/MongolBanner175.txt"
B76 = "countries/MongolBanner176.txt"
B77 = "countries/MongolBanner177.txt"
B83 = "countries/MongolBanner183.txt"
B84 = "countries/MongolBanner184.txt"
B85 = "countries/MongolBanner185.txt"
B86 = "countries/MongolBanner186.txt"
B87 = "countries/MongolBanner187.txt"
B88 = "countries/MongolBanner188.txt"
B89 = "countries/MongolBanner189.txt"
B90 = "countries/MongolBanner190.txt"
B91 = "countries/MongolBanner191.txt"
B92 = "countries/MongolBanner192.txt"
B93 = "countries/MongolBanner193.txt"
B94 = "countries/MongolBanner194.txt"
B95 = "countries/MongolBanner195.txt"
B96 = "countries/MongolBanner196.txt"
B97 = "countries/MongolBanner197.txt"
B98 = "countries/MongolBanner198.txt"
B99 = "countries/MongolBanner199.txt"
I00 = "countries/MongolBanner200.txt"
I01 = "countries/MongolBanner201.txt"
I02 = "countries/MongolBanner202.txt"
I03 = "countries/MongolBanner203.txt"
I04 = "countries/MongolBanner204.txt"
I05 = "countries/MongolBanner205.txt"
I07 = "countries/MongolBanner207.txt"
I08 = "countries/MongolBanner208.txt"
I09 = "countries/MongolBanner209.txt"
I10 = "countries/MongolBanner210.txt"
I11 = "countries/MongolBanner211.txt"
I12 = "countries/MongolBanner212.txt"
I13 = "countries/MongolBanner213.txt"
I14 = "countries/MongolBanner214.txt"
I15 = "countries/MongolBanner215.txt"
PCK = "countries/Pimicikamak.txt"
S00 = "countries/ShanState0.txt"
S01 = "countries/ShanState1.txt"
S02 = "countries/ShanState2.txt"
S03 = "countries/ShanState3.txt"
S04 = "countries/ShanState4.txt"
S05 = "countries/ShanState5.txt"
S06 = "countries/ShanState6.txt"
S07 = "countries/ShanState7.txt"
S08 = "countries/ShanState8.txt"
S09 = "countries/ShanState9.txt"
S10 = "countries/ShanState10.txt"
S11 = "countries/ShanState11.txt"
S12 = "countries/ShanState12.txt"
S13 = "countries/ShanState13.txt"
S14 = "countries/ShanState14.txt"
S15 = "countries/ShanState15.txt"
S16 = "countries/ShanState16.txt"
S17 = "countries/ShanState17.txt"
S18 = "countries/ShanState18.txt"
S19 = "countries/ShanState19.txt"
S20 = "countries/ShanState20.txt"
S21 = "countries/ShanState21.txt"
S22 = "countries/ShanState22.txt"
S23 = "countries/ShanState23.txt"
S24 = "countries/ShanState24.txt"
S25 = "countries/ShanState25.txt"
S26 = "countries/ShanState26.txt"
S27 = "countries/ShanState27.txt"
S28 = "countries/ShanState28.txt"
S29 = "countries/ShanState29.txt"
S30 = "countries/ShanState30.txt"
S31 = "countries/ShanState31.txt"
S32 = "countries/ShanState32.txt"
S33 = "countries/ShanState33.txt"
S34 = "countries/ShanState34.txt"
S35 = "countries/ShanState35.txt"
S36 = "countries/ShanState36.txt"
S37 = "countries/ShanState37.txt"
S38 = "countries/ShanState38.txt"
S39 = "countries/ShanState39.txt"
S40 = "countries/ShanState40.txt"
S41 = "countries/ShanState41.txt"
S42 = "countries/ShanState42.txt"
S43 = "countries/ShanState43.txt"
S44 = "countries/ShanState44.txt"
S45 = "countries/ShanState45.txt"
S46 = "countries/ShanState46.txt"
S47 = "countries/ShanState47.txt"
S48 = "countries/ShanState48.txt"
S49 = "countries/ShanState49.txt"
S50 = "countries/ShanState50.txt"
S51 = "countries/ShanState51.txt"
S52 = "countries/ShanState52.txt"
S53 = "countries/ShanState53.txt"
S54 = "countries/ShanState54.txt"
S55 = "countries/ShanState55.txt"
S56 = "countries/ShanState56.txt"
S57 = "countries/ShanState57.txt"
S58 = "countries/Zomi Revolutionary Army.txt"
S59 = "countries/United Wa State Army.txt"
S60 = "countries/Arakan Army.txt"
S61 = "countries/People's Defence Force.txt"
S62 = "countries/Karenni Nationalities Defence Force.txt"
S63 = "countries/Chin National Army.txt"
S64 = "countries/Kachin Independence Army.txt"
S65 = "countries/Karen National Liberation Army.txt"
S66 = "countries/Ta'ang National Liberation Army.txt"
S67 = "countries/Myanmar National Democratic Alliance Army.txt"
S68 = "countries/Shan State Army - North.txt"
S69 = "countries/Shan State Army - South.txt"
S70 = "countries/Mon National Liberation Army.txt"
S71 = "countries/National Democratic Alliance Army.txt"
S72 = "countries/Pa-O National Liberation Army.txt"
IQK = "countries/Iraqi Kurdistan.txt"
BCM = "countries/British Commonwealth.txt"
HG1 = "countries/G9 Family.txt"
HG2 = "countries/Kraze Barye.txt"
HG3 = "countries/Baz Taliban.txt"
AMF = "countries/Fano.txt"
LB2 = "countries/National Patriotic Front of Liberia.txt"
SD1 = "countries/Sudan Liberation Movement.txt"
SD2 = "countries/Sudan People's Liberation Army.txt"
SD3 = "countries/Revolution Movement for Southern Chad.txt"
SD4 = "countries/Popular Rally for Justice and Equality in Chad.txt"
SD5 = "countries/Azande Militias.txt"
ACD = "countries/Acadiana.txt"
HPI = "countries/Hopi.txt"
CM0 = "countries/Biafra Nations League.txt"
CM1 = "countries/Ambazonia Defence Forces.txt"
CM2 = "countries/South Cameroons Defence Forces.txt"
CM3 = "countries/Team Retina.txt"
CM4 = "countries/Tigers of Ambazonia.txt"
CM5 = "countries/Ambazonia Restoration Forces.txt"
CM6 = "countries/South Cameroons Restoration Forces.txt"
CM7 = "countries/Seven Karta.txt"
CM8 = "countries/Bui Warriors.txt"
CM9 = "countries/Bambalang Marine Forces.txt"
BEK = "countries/Sovereign State of the Bektashi Order.txt"
BEN = "countries/Republic Benin 1967.txt"